[console_scripts]
psec = psec.main:main

[psec]
environments create = psec.environments.create:EnvironmentsCreate
environments default = psec.environments.default:EnvironmentsDefault
environments delete = psec.environments.delete:EnvironmentsDelete
environments list = psec.environments.list:EnvironmentsList
environments path = psec.environments.path:EnvironmentsPath
environments rename = psec.environments.rename:EnvironmentsRename
environments tree = psec.environments.tree:EnvironmentsTree
groups create = psec.groups.create:GroupsCreate
groups delete = psec.groups.delete:GroupsDelete
groups list = psec.groups.list:GroupsList
groups path = psec.groups.path:GroupsPath
groups show = psec.groups.show:GroupsShow
run = psec.run:Run
secrets backup = psec.secrets.backup:SecretsBackup
secrets create = psec.secrets.create:SecretsCreate
secrets delete = psec.secrets.delete:SecretsDelete
secrets describe = psec.secrets.describe:SecretsDescribe
secrets generate = psec.secrets.generate:SecretsGenerate
secrets get = psec.secrets.get:SecretsGet
secrets path = psec.secrets.path:SecretsPath
secrets restore = psec.secrets.restore:SecretsRestore
secrets send = psec.secrets.send:SecretsSend
secrets set = psec.secrets.set:SecretsSet
secrets show = psec.secrets.show:SecretsShow
ssh config = psec.ssh:SSHConfig
ssh known-hosts add = psec.ssh:SSHKnownHostsAdd
ssh known-hosts extract = psec.ssh:SSHKnownHostsExtract
ssh known-hosts remove = psec.ssh:SSHKnownHostsRemove
template = psec.template:Template
utils myip = psec.utils.myip:MyIP
utils myip methods = psec.utils.myip:MyIPMethods
utils netblock = psec.utils.netblock:Netblock
utils set-aws-credentials = psec.utils.set_aws_credentials:SetAWSCredentials
utils tfstate backend = psec.utils.tfbackend:TfBackend
utils tfstate output = psec.utils.tfoutput:TfOutput
utils yaml-to-json = psec.utils.yaml_to_json:YAMLToJSON

